65
30 50
200
1.5 1.5
-
BBBBBBBBBBBBBBBBBBBBBBBBBBBBBBBBBBBBBBBBBBBBBBBBBB
BMEEEERRREEEEEEBEEEEREREREEEEEEREREEREEEEEEEEEEEEB
BEEEEEEEEEEEEEEBEEEREREEEEEEEEEEEEERRE*EEEEEEEEEEB
BEEREREEREEEEEEBEEEERRERRRREEEEEE*EEEEEEEEE*EEREEB
BEEERE*EEEREEEEBEEEEERREEEEEEEEEEEEEERE*EEEERREEEB
BEEREREEE*EEREEBEEREREREEEEEEEEEEEEEEEEEEEEEEEEEEB
BEEEEEEEEEEEE*EBEREEEEREREEEEEEREEEEE*EEEEREEEEEEB
BEEEEE*REREEEEEBEEREEEEEEEEREEEEEEEEEREEEEEEEEREEB
BERREERER*EEREEBERREEEE*EEEEEEEEEEEEEEERERERREEERB
BEEEEREE*EEE*EEBEEEEEERE*EREEEEEEEEEEEEEEREEEEEEEB
BEEEEEEEEEEEREEBEEREE*EEEREEEE*EEEEEEEEREEEEEERREB
BEE*ERREREE*EEEBEERERREEEEEEEEEEEE*EEEEE*EEEEEEEEB
BEE*EE*EEREEEEEBEEREE*EEREREREEEEEEEEEREREREEEEEEB
BEEREEREEEEEREEBEEREEEEEEEEEEEEEEREEEEEEEEE*EEEEEB
BREEEEREE*EE*EEBEEEEEE*EEEEREEEEEEEE*EEE*EEEEEEEEB
BREEEREE*EEEEEEBEEEEEEEEEEEEEEEEEEEE*EEEEEEEEEEEEB
BEEEEEEREEEE*EEBEEEEEEEE*EEEREREEEEEEEE*EEEEREEEEB
BEEEEEEEEREEEEEBEEEEEEEEEREEEEEEEEEEEEEE*EEEEREEEB
BEEREERE*EEEEEEBEEEEEEREEE*EEEEEEEEEEEEEEE*EEEREEB
BEEEEE*EEEREEEEBEEEEEEEEEEEEEEEEEEEEREEEEEEEEEEEEB
BEEREREEEEEEEEEBEEEEEEEEEEE*EEEEEEEEREEREEE*EEEEEB
BEEEEE*EEE*EEEEEEEEEEEE*E*EEEEEEEEEEEE*EREER*EREEB
BEEE*EEREEEEE*EEEEE*EEEEEEEEEEEEEEREEEEEREEEEEREEB
BEEEEEE*EERRREEEEEEE*EEEEEEEEEEEEERERE*EEEEE*EEEEB
BEEE*EEEEEEEEE*EEEEEEEEEEEEEEEEEE*EREEEEE*EEE*EEEB
BEEEREEEERREEEEBEEE*EEEE*EEE*EEEEEEEEREERERREEEEEB
BEEREREREERRREEBEEEEREEEEEEEEEEE*EEEEEEEEEEREEEEEB
BEEE*EEE*EEREREBEEEEEEEEEEEEEEEEEEEEEREEEEEEEEEEEB
BBBBBBBBBBBBBBBBBBBBBBBBBBBBBBBBBBBBBBBBBBBBBBBBBB
BBBBBBBBBBBBBBBBBBBBBBBBBBBBBBBBBBBBBBBBBBBBBBBBBB