70
30 50
150
1.5 1.4
-
BBBBBBBBBBBBBBBBBBBBBBBBBBBBBBBBBBBBBBBBBBBBBBBBBB
BMEERRREEEEEEEEEEERREEEEEEEEREEEEEEEEEEEEEEEEREEEB
BEEEEEEE*EREEEEEEEER**EREEEEEERREEEEEEEEEEEEREREEB
BEEEEER*EE*EEEEEE*EEEEEEREEEEREEEERERREEEEEE*EEEEB
BEREEEREREE*EEEEEEEEEERERE*EEEEEEE*E**REEEREEEEREB
BEREEREEREEEEEEEEEEEEEEEEEEEEEEREEEEEREEEREEEEE*EB
BE*EEEEEEEEEEEEEEEEEEEEEEEEEEEEEEEEEEEERRREE*EEEEB
BBBBBBBBBBBBBBBBBBBBBBBEEEEBBBBBBBBBBBBBBBBBBBBBBB
BREEEEEEEEEEEEEEREEEEEEEEEEEERREEEEEEEEEEEEEERE*EB
BEEEERREEREEEEEEREERREEEEREEEEERREEEEREEE*EERREEEB
BREREEEEEREEREEEREEEEEEEEERREEEEEEEER*EEEREEE*REEB
BE*EER*EREEEEEREEEREEREEEEEEEEEEERREEEEEEE*EEEEEEB
BEREE*EEEEEREEREEEEEEEEEEEEEEEEEEEEEREEEEEEE*EEEEB
BE*E*E*EREEEREEEEEEEEEEEEEEEEEEEEEEEEEEEEEEEEEEEEB
BBBBBBEEEEBBBBBBBBBBBBEEREEEBBBBBBBBBBBBBBBEEEEBBB
BEEEREEEEEE*EEEEERE*EEEEEEE*EEEEEEREEEEEEEE*EEE*EB
BEERRRRREEEEEEREEEEEE*ERE*EEEEEREEEEEREEREEE*EEEEB
BERRE*REEREEREEEEEEEREEEEREERE*EEEEEE*EE*EEREEEEEB
BE*ERERREEER*E*EEEEEEEEEEEREEEEE*EEEEEEEEEE*EEE*EB
BE*REEE*EEEREEEEREERRREEEEEEEEEEEREEEEREEEEEEEEEEB
BEE*REERREEEEREEE*E**EEERREEEEEREEE*EEEEREEREEEEEB
BE*EEEREEER*EEEE*REEEEEEEREEEEEEEEREEEE*EEEEEEREEB
BBBBEEEEEEEEEBBBBBBBBBBBBBBBBBBBBBBBBBBBBBBBBBBBBB
BREERERREE*EERE*REEEEEEREEEREEEEEEEEERREEEREE*EREB
BERREE*EE*E*EEEREEE*EEEEEEEE*EEEEEERREREEEEEEEEERB
BEEEREREEREEEEEEEE*EEE*EEE*EEEE*EEEEEEEEEEEREEREEB
BERE*EREEREREEEEEEEEERERREEEEEEEEEEEREEEREEREREEEB
BER*EEEREEEREEEEREEEREEEEEEEEEEEEEEEREREREEREEEEEB
BEREEEREEEEREEEEEREREEEEEEEEREREEEREEEREEEEEEEEEEB
BBBBBBBBBBBBBBBBBBBBBBBBBBBBBBBBBBBBBBBBBBBBBBBBBB


	
	