56
50 50
250
1.5 1.22
-
BBBBBBBBBBBBBBBBBBBBBBBBBBBBBBBBBBBBBBBBBBBBBBBBBB
BMEEEEEEEEEEEEEEEEEEEEEEEEEEEEEEEEEEEEEEEEEEREEWEB
BEEREEEEEEREEEEEEEEEEEEEEEEEEEEEEEEREEEREEEREEEEEB
BEEEEEREEREEEEEREEEEEEEREEEEEEEEEEEEEEEEREEREEEEEB
BEEEEEEEEEEEEEEEEEEEEEEEEEEEEEEEEREEEEEEEEREEEEEEB
BEEEEEEEEEEEE*EE*EEEEEEEEEEEEEEEEEEEEEEEEEEEEREEEB
BEEEEEEEEEEEEEEEEEEE*EEEEEEEEEEEEEEEEEEEEEEEEEEEEB
BERREEEEEEEEEREEEEEEEEEEEEEEEEEEEE*EEEEEEEERREEEEB
BEEREEEEEEEERREEEEEEEEEEEEEEEEEEEEE*EEEEEEREEEREEB
BEEEEEEEEEEEEEE*EEEEEEEEEEEEEEEEEEEEEEEEEEEEEEEEEB
BEEEEEEEEEEEEEEEEEEEEEEEEEEEEEEEEEEEEEEEEEEEEEEEEB
BEEEEEEEEE*RER*EEEEEEEEEEEEEEE*EEEEEEEEEEEEEEEEEEB
BEEEEEEEEEEEEEEEEEEEEEEEEEEEEEEEEEEEEEEEEEEEEEEEEB
BEEEEEEEEEEEEEEEEEEEE*EEEEEEEEEEEEEEEEEEEEEEEEEEEB
BBBBBBBBBBBEEEEEBBBBBBBBBBEEEEEEBBBBBBBBBBBBBBBBBB
BEEEEEEEERERREREEEEEEEEEERERERE*EEEEEEEEEREREREREB
BEEEEEREREEEEEEEEEEEEEEEEREREEEEEEEEEEEEEEEEREREEB
BEEEEEEE*EEEEEEEEEEEEEREREEEEEEEEEEEEEEEEE*EEEEEEB
BEEEEEEEEEEEEREEREER*EEEEEEEEEEEEEEEREEEEEEEEEEEEB
BEEEEEREREEEEEEEEEEEEEEEEEEREREEEEEEEEEEEEEEEEEEEB
BEEEEEEREEEEEEREREEEEEEEEEEEEEEEEEEEEEEEREEREEEEEB
BEEEEEEEEEEEEEEREEEEEEEREEEEEEEEEEEEEEEEEEE*EEEEEB
BEEEEEEREEE*EEEREEEEEEEEEEEEEEEEEEEE*EEEEEEEEEEEEB
BEEEE*EEEREREREEEEEEEEEEEE*EEEEE*EEEEEEEEEEEEEEEEB
BEEEEEEEREEEEEEEEEEEEEEEEEEEREEEE*EEEEEEEEREEE*EEB
BEEEEEREEEEEEEEEEEEEEREEEEEEEEEEEEEEEEEEEEEEEEEEEB
BEEEREE*EEE*EEEEEEEEEEEEEEREEEREEEEEEREEEEEEEEEEEB
BEEEEEEREEEREEEBBBBBEEEEEEEEEBBBBBEEREEEEEEREEEEEB
BEEEEEEEEEEEEREB*R*BEEEEEEEEEB*R*BEEEEEEEEEEEEEEEB
BEEEEEEEEEEEEEEB*R*BEEEEEEEEEB*R*BEEEEEEEEEEEEEEEB
BEEEEEEEEEEEEEEB*R*BEEEEEEEEEB*R*BEEEEEEEEEEEEEEEB
BEEEEEEEEEEEEEEB*R*BEEEEEEEEEB*R*BEEEEEEEEEEEEEEEB
BEEEEEEEEEEEEEEBEREBEEEEEEEEEBEREBEEEEEEEEEEEEEEEB
BEEEEEEEEEEEEEEBEREBEEEEEEEEEBEREBEEEEEEEEEEEEEEEB
BEEEEEEEEEEEEEEBEREBEEEEEEEEEBEREBEEEEEEEEEEEEEEEB
BEEEEEEEEEEEEEEB*R*BEEEEEEEEEB*R*BEEEEEEEEEEEEEEEB
BEEEEEEEEEEEEEEB*R*BEEEEEEEEEB*R*BEEEEEEEEEEEEEEEB
BEEEEEEEEEEEEEEB*R*BEEEEEEEEEB*R*BEEEEEEEEEEEEEEEB
BEEEEEEEEEEEEEEB*R*BEEEEEEEEEB*R*BEEEEEEEEEEEEEEEB
BEEEEEEEEEEEEEEBBEBBEEEEEEEEEBBEBBEEEEEEEEEEEEEEEB
BEEEEEEEEEEEEEEEEEEEEEEEEEEEEEEEEEEEEEEEEEEEEEEEEB
BEEEEEEEEEEEEEEEEEEEEEEEEEEEEEEEEEEEEEEEEEEEEEEEEB
BEEEEEEEEEEEEEEEEEEEEEEEEEEEEEEEEEEEEEEEEEEEEEEEEB
BEEEEEEEEEEEEEEEEEEEEEEEEEEEEEEEEEEEEEEEEEEEEEEEEB
BEEEEEEEEEEEEEEEEEEEEEEEEEEEEEEEEEEEEEEEEEEEEEEEEB
BEEEEEEEEEEEEEEEEEEEEEEEEEEEEEEEEEEEEEEEEEEEEEEEEB
BEEEEEEEEEEEEEEEEEEEEEEEEEEEEEEEEEEEEEEEEEEEEEEEEB
BEEEEEEEEEEEEEEEEEEEEEEEEEEEEEEEEEEEEEEEEEEEEEEEEB
BEEEEEEEEEEEEEEEEEEEEEEEEEEEEEEEEEEEEEEEEEEEEEEEEB
BBBBBBBBBBBBBBBBBBBBBBBBBBBBBBBBBBBBBBBBBBBBBBBBBB