35
50 50
120
1.5 1.22
-
BBBBBBBBBBBBBBBBBBBBBBBBBBBBBBBBBBBBBBBBBBBBBBBBBB
BMEEEEEEBEEEEEEEEEEEEEEEEEEWEEEEEEEEEEEEEEEEREEEEB
BEEREEEEBEREEEEEEEEEEEEEEEEEEEEEEEEREEEREEEREEEEEB
BEEEEEREBREEEEEREEEEEEEREEEEEEEEEEEEEEEEREEREEEEEB
BEEEEEEEBEEEEEEEEEEEEEEEEEEEEEEEEREEEEEEEEREEEEEEB
BEEEEEEEBEEEE*EE*EEEEEEEEEEEEEEEEEEEEEEEEEEEEREEEB
BEEEEEEEBEEEEEEEEEEE*EEEEEEEEEEEEEEEEEEEEEEEEEEEEB
BEBBBBBBBEEEEREEEEEEEEEEEEEEEEEEEE*EEEEEEEERREEEEB
BEEREEEEBEERREEEEEEEEEEEEEEEEEEEEE*EEEEEEREEEREEEB
BE*EEEEEBEEEEE*EEEEEEEEEEEEEEEEEEEEEEEEEEEEEEEEEEB
BEEEEEEEEEEEEEEEEEEEEEEEEEEEEEEEEEEEEEEEEEEEEEEEEB
BEEEEEEEB*RER*EEEEEEEEEEEEEEE*EEEEEEEEEEEEEEEEEEEB
BEEEEEEEBEEEEEEEEEEEEEEEEEEEEEEEEEEEEEEEEEEEEEEEEB
BBBBBBBBBBBBBBBBBBBBBBBBBBBB  BBBBBBBBBBBBBBBBBBBB
BEEEEEEEEEEEEEEEEEEEEEEEEEEEEEEEEEEEEEEEEEEEEEEEEB
BEEEEEEEERERREREEEBBBBBBBBBBBBBBBBBBBBBBBBBBBBBBBB
BEEEEE  S  EEEEEEEBEEEEEEREREEEEEEEEEEEEEEEEREREEB
BEEEEE *** EEEEEEEBEEEREREEEEEEEEEEEEEEEEEREEEEEEB
BEEEEE  S  EEREEREBR*EEEEEEEEEEEEEEEREEEEEEEEEEEEB
BEEEEEREREEEEEEEEEBEEEEEEEEREREEEEEEEEEEEEEEEEEEEB
BEEEEEEREEEEEEREREEEEEEEEEEEEEEEEEEEEEEREEREEEEEEB
BBBBBBBBBBBBBBBBBBBBBBBBBBBBBBBBBBBBBBBBBBBB   BBB
BEEEEEEREEEREEEREEBEEEEEEEEEEEEEEEEE*EEEEEEEEEEEEB
BEEEEREEEREREREEEEEEEEEEEE*EEEEE*EEEEEEEEEEEEEEEEB
BEEEEEEEREEEEEEEEEEEEEEEEEEEREEEE*EEEEEEEEREEE*EEB
BEEEEE         EEEEEEREEEEEEEEEEEEEEEEEEEEEEEEEEEB
BEEERE    !    EEEEEEEEEEREEEREEEEEEREEEEEEEEEEEEB
BEEEEE    *    EEEEEEEEEEEEEEEEEEEEEREEEEEEREEEEEB
BEEEEE    *    EEEEEEEEEEEEEEEEEEEEEEEEEEEEEEEEEEB
BEEEEE    *    EEEEEEEEEEEEEEEEEEEEEEEEEEEEEEEEEEB
BEEEEE    *    EEEEEEEEEEEEEEEEEEEEEEEEEEEEEEEEEEB
BEEEEE    *    EEEEEEEEEEEEEEEEEEEEEEEEEEEEEEEEEEB
BEEEEE    !    EEEEEEEEEEEEEEEEEEEEEEEEEEEEEEEEEEB
BBBBBBBEEBBBBBBBBBBBBBBBBBBBBBBBBBBBBBBBBBBBBBBBBB
BEEEEEEEREEEEEEBEEEEEEEEEEEEEBEEEEEEEEEEEEEEEEEEEB
BEEEEEEE*EEEEEEBEEEEEEEEEEEEEBEEEEEEEEEEEEEEEEEEEB
BEEEEEEEREEEEEEBEEEEEEEEEEEE   SEEEEEEEEEEEEEEEEEB
BEEEEEEE*EEEEEEBEEEEEEEEEEEE    EEEEEEEEEEEEEEEEEB
BEEEEEEEREEEEEEBEEEEEEEEEEEEEBEEEEEEEEEEEEEEEEEEEB
BEEEEEEE*EEEEEEBEEEEEEEEEEEEEBEEEEEEEEEEEEEEEEEEEB
BEEEEEEEREEEEEEBEEEEEEEEREEEEBEEEEEEEEEEEEEEEEEEEB
BEEEEEEE*EEEEEEBEEEEEEEEEEEEEBEEEEEEEEEEEEEEEEEEEB
BEEEEEEEREEEEEEBEEEEEEEEEEEEEBEEEEEEEEEEEEEEEEEEEB
BEEEEEEE*EEEEEEBEEEEEEEEEEEEEBEEEEEEEEEEEEEEEEEEEB
BEEEEEEEREEEEEEBEEEEEEEEEEEEEBEEEEEE****EEEEREEEEB
BEEEEEEE*EEEEEEBEEEEEEEEEEEEEBEEEEEEEEEEEEEEEEEEEB
BEEEEEEEREEEEEEBEEEEEEEEEEEEEBEEEEEEEEEEEEEEEEEEEB
BEEEEEEE*EEEEEEBEEEEEEEEEEEEEBEEEEEEEEEEEEEEEEEEEB
BEEEEEEEEEEEEEEEEEEEEEEEEEEEEBEEEEEEEEEEEEEEEEEEEB
BBBBBBBBBBBBBBBBBBBBBBBBBBBBBBBBBBBBBBBBBBBBBBBBBB