16
25 45
50
1.5 1.5
-
BBBBBBBBBBBBBBBBBBBBBBBBBBBBBBBBBBBBBBBBBBBBB
BMEEEEEEEEEEEEEEEEEEEEEEEEEEEEEEEEEEEEEEEEEEB
BEEEEEEEEEEEEREEEEEREEEEEEREEEEEEREEEEEEEEEEB
BEEEEEEEEEREEREEEREEEREEEEREEEEEEEEEEEEEEEEEB
BEEEEEEEEEEEEEEEEEEEEEEEEEEEEEREEEEEEEEEEEEEB
BEEEEEEEEEEEEEEEEEEEEEEEEEEEEEEEEEEEEEEEEEEEB
BEEEEEEEEEEEEEEEEEEEEEEEEEEEEEEEEEEEEEEEEEEEB
BEEEEEEEEEEEEEEEEEEEEEEEEEEEEEEEEEEEEEEEEEEEB
BEEEEEEEEEEEEEEEEEEEEEEEEEEEEEEEEEEEEEEEEEEEB
BEEEEEEEEEEEEEREEREEEEEEERREEREEEEEEEEEEEEEEB
BEEEEEEEEEEEEEEEEEEEEEEEEEEEEEEEEEEEEEEEEEEEB
BEEEEEEEEEEEEEEEEEEEEEEEEEEEEEEEEEEEEEEEEEEEB
BEEEEEEEEEEEEEEES  EEEEEEEES  EEEEEEEEEEEEEEB
BEEEEEEEEEEEEEEE   EEEEEEEE   EEEEEEEEEEEEEEB
BEEEEEEEEEEEEEEEEEEEEEEEEEEEEEEEEEEEEEEEEEEEB
BEEEEEEEEEEEEEEEEEEEEEEEEEEEEEEEEEEEEEEEEEEEB
BEEEEEEEEEEEEEEEEEEEEEEEEEEEEEEEEEEEEEEEEEEEB
BEEEEEEEEEEEEEEEEEEEEEEEEEEEEEEEEEEEEEEEEEEEB
BEEEEEEEEEEEEEEEEEEEEEEEEEEEEEEEEEEEEEEEEEEEB
BEEEEEEEEEEEEEEEEEEEEEEEEEEEEEEEEEEEEEEEEEEEB
BEEEEEEEEEEEEEEEEEEEEEREEEEEEEEEEEEEEEEEEEEEB
BEEEEEEEEEEEEEEEEEEEEEEEEEEEEEEEEEEEEEEEEEEEB
BEEEEEEEEEEEEEEEEEEEEEEEEEEEEEEEEEEEEEEEEEEEB
BEEEEEEEEEEEEEEEEEEEEEEEEEEEEEEEEEEEEEEEEEEEB
BBBBBBBBBBBBBBBBBBBBBBBBBBBBBBBBBBBBBBBBBBBBB